CAT = "countries/Catalonia.txt"
GLC = "countries/Galicia.txt"
BRI = "countries/Brittany.txt"
OCC = "countries/Occitania.txt"
COR = "countries/Corsica.txt"

CEC = "countries/CentreCercle.txt"
CEM = "countries/CentreMarxists.txt"
CES = "countries/CentreSalut.txt"

PIE = "countries/Piemont.txt"
AOS = "countries/Aosta.txt"
LIG = "countries/Liguria.txt"
ADE = "countries/Ademus.txt"
ZEE = "countries/Zeeland.txt"
HLL = "countries/Holland.txt"
FRI = "countries/Frisia.txt"
BRT = "countries/Brabant.txt"
GRL = "countries/Grld.txt"

MRP = "countries/Murska.txt"
STA = "countries/Štajerska.txt"
KRA = "countries/Kranjska.txt"
SKR = "countries/Karnten.txt"

LXM = "countries/Luxembourg.txt"
EPE = "countries/Eupen.txt"
VLD = "countries/Vlaanderen.txt"
BRS = "countries/Brussels.txt"
WLL = "countries/Wallonia.txt"
ARN = "countries/Aran.txt"
FNL = "countries/Fenolleda.txt"
LEO = "countries/Leon.txt"
VAL = "countries/Valencia.txt"
ADA = "countries/AndalusianState.txt"
MLL = "countries/Mallorca.txt"
VAS = "countries/Vasconia.txt"
ASR = "countries/Asturias.txt"
CAB = "countries/Cantabria.txt"
NAR = "countries/Navarra.txt"
CAV = "countries/CastillaLaVieja.txt"
ARA = "countries/Aragón.txt"
CAL = "countries/CastillaLaMancha.txt"
CAM = "countries/CeutaAndMelilla.txt"
EXT = "countries/Extremadura.txt"
LAR = "countries/LaRioja.txt"
CNR = "countries/LasCanarias.txt"
MDR = "countries/Madrid.txt"
MUR = "countries/Murcia.txt"
PRP = "countries/Perpinya.txt"
NAF = "countries/Nafarroa.txt"
GRA = "countries/Granada.txt"
EDM = "countries/Entredouroeminho.txt"
TMD = "countries/TrasOsMontesEAltoDouro.txt"
AQU = "countries/Aquitania.txt"
PRO = "countries/Provence.txt"
AUV = "countries/Auvergne.txt"
ALA = "countries/Algarve.txt"
ALE = "countries/Alentejo.txt"
ESR = "countries/Estremadura.txt"
BEI = "countries/Beira.txt"
GIB = "countries/Gibraltar.txt"
COC = "countries/CatOcc.txt"
ANR = "countries/Andorra.txt"
APO = "countries/Andport.txt"
LOI = "countries/Loire.txt"
SAR = "countries/Sardigna.txt"
POI = "countries/Poitou.txt"
SPL = "countries/SpanishLoyalists.txt"
LIM = "countries/Limousin.txt"
RHO = "countries/Rhone.txt"
LAN = "countries/Languedoc.txt"
PEI = "countries/Peirosa.txt"
MNC = "countries/Monaco.txt"
HUE = "countries/Huelva.txt"
BOU = "countries/Bourgogne.txt"
CEN = "countries/Centre.txt"
BNO = "countries/Normandie B.txt"
HNO = "countries/Normandie H.txt"
PIC = "countries/Picardie.txt"
NPC = "countries/NPC.txt"
CMP = "countries/Champagne.txt"
LOR = "countries/Lorraine.txt"
ALS = "countries/Alsace.txt"
FCO = "countries/Franche Comte.txt"
PRS = "countries/Ille.txt"
JER = "countries/Jersey.txt"
PIR = "countries/Pic Revolt.txt"